1 1 1 1 1 1 1 1 1 1 1 1 1 1 1 1
2 2 2 2 2 2 2 2 2 2 2 2 2 2 2 2
2 2 2 2 2 2 2 2 2 2 2 2 2 2 2 2
5 5 5 5 5 5 5 5 5 5 5 5 5 5 5 5
3 0 0 6 0 6 4 0 6 4 0 0 6 0 6 3
3 0 0 0 4 0 0 6 0 6 0 4 0 0 0 3
3 0 6 0 6 0 4 0 6 0 0 0 0 0 0 3
3 6 0 4 0 0 6 6 0 4 6 0 0 6 4 3
1 1 1 1 1 1 1 1 1 1 1 1 1 1 1 1
2 2 2 2 2 2 2 2 2 2 2 2 2 2 2 2
2 2 2 2 2 2 2 2 2 2 2 2 2 2 2 2
5 5 5 5 5 5 5 5 5 5 5 5 5 5 5 5